name	str
dist	float
support	float
seed_ortholog	str
evalue	float
score	float
eggNOG_OGs	list
max_annot_lvl	str
COG_category	str
Description	str
Preferred_name	str
GOs	list
EC	str
KEGG_ko	list
KEGG_Pathway	list
KEGG_Module	list
KEGG_Reaction	list
KEGG_rclass	list
BRITE	list
KEGG_TC	list
CAZy	list
BiGG_Reaction	list
PFAMs	list
alignment	str
dom_arq	str
seed_ortholog_counter	str
max_annot_lvl_counter	str
COG_category_counter	str
Description_counter	str
Preferred_name_counter	str
EC_counter	str
eggNOG_OGs_counter	str
GOs_counter	str
KEGG_ko_counter	str
KEGG_Pathway_counter	str
KEGG_Module_counter	str
KEGG_Reaction_counter	str
KEGG_rclass_counter	str
BRITE_counter	str
KEGG_TC_counter	str
CAZy_counter	str
BiGG_Reaction_counter	str
PFAMs_counter	str
dist_avg	float
dist_sum	float
dist_max	float
dist_min	float
dist_std	float
support_avg	float
support_sum	float
support_max	float
support_min	float
support_std	float
evalue_avg	float
evalue_sum	float
evalue_max	float
evalue_min	float
evalue_std	float
score_avg	float
score_sum	float
score_max	float
score_min	float
score_std	float
rank	str
sci_name	str
taxid	str
lineage	str
named_lineage	str
evoltype	str
dup_sp	str
dup_percent	float
